11111111111111111111111111111111111111111111111111111111111
13000000000000120300000000000000000003000000000000000000031
10000000000000120000000000000000000000000000000000000000001
10000222200000120000202000000000000000000000000000000000001
10000222200000012000000000000000000000000000000000000000001
10000222200000001200002000000000000000000110000000000000001
11110111110000000120000000000020000200300110000022220000001
13000000000000000011100020300020000200000110000030000000001
10000020000000000000000000000020000002000000000000220000001
10000020000000000000100000000000000000202000000000000000001
10000020000000000000000020000000000000002000000000000000031
10000020000000000000100000000010000000000022000000000000001
10000000000000000000000020000010000000000022000030000000001
10000022220000000000100000000011000000300022000111110000001
10000022220000000000000020300000000000000022000000000000001
11101111000000000000100000000000112000000000000300000000001
13000000000000000000000020000002122000000000000002220000001
10000000202000000000100000000002120000000000022220000000031
10000000000000000000000020000002120000002000000002200000001
10000000000000000000100000000000000000000200000000220000001
11112110000000000000000020000000100000000200110002002000001
10000002222000000000000100300000000000300000110002022000001
10000002222000000000000000000000100000000000000000000000001
10000000000000000000100000000000000000000000000000000000001
13000000000000000000003000000000000000030000000000000000031
11111111111111111111111111111111111111111111111111111111111
