1111111111111111111
1000022003002200001
1000022000002200001
1000022000002200001
1000022000002200001
1000022000002200001
1000322222222230001
1222222222222222221
1000000000000000001
1222222222222222221
1000030002000300001
1000000001000000001
1000000002000000001
1000000001000000001
1222222221222222221
1000000002000000001
1000030001000030001
1000000002000000001
1000000001000000001
1111111111111111111
