11111111111111111111111111111111111111111
13000000000000000000000000000000000000031
10121212121212121212121212121212121212101
10020000000000000000000000000000000002001
10121010131010101010101010101013101012101
10020000000000000000000000000000000002001
10121010121212121212121212121212101012101
10020000020000000000000000000002000002001
10121010121010101010101010101012101012101
10020000020000000003000000000002000002001
10121010121010101010101010101012101012101
10020000020000000000000000000002000002001
10121010121010101010101010101012101012101
10020000020000000000000000000002000002001
10121010121010101010101010101012101012101
10020000020000000000000000000002000002001
10121010121010101010101010101012101012101
10020000020000222222222220000002000002001
10121010121010101010101010101012101012101
10020000020000200003000020000002000002001
10121010121010101010101010101012101012101
10020000020000222222222220000002000002001
10121010121010101010101010101012101012101
10020000020000000000000000000002000002001
10121010121010101010101010101012101012101
10020000020000000000000000000002000002001
10121010121010101010101010101012101012101
10020000020000000000000000000002000002001
10121010121010101010101010101012101012101
10020000020000000003000000000002000002001
10121010121010101010101010101012101012101
10020000020000000000000000000002000002001
10121010121212121212121212121212101012101
10020000000000000000000000000000000002001
10121010131010101010101010101013101012101
10020000000000000000000000000000000002001
10121010101010101010101010101010101012101
10020000000000000000000000000000000002001
10121212121212121212121212121212121212101
13000000000000000000000000000000000000031
11111111111111111111111111111111111111111
