1111111111111111111111
1300000020302200000031
1000000020002200100001
1000000020002200000001
1222222222222222222221
1222222222222222222221
1000000220002200000001
1300100220002200100031
1000000220002200000001
1222222222222222222221
1222222222222222222221
1000000220002200000001
1000000220002200000001
1000000220002200000001
1300000220302200000031
1111111111111111111111
