111111111111111111111111111111
122222222222222222222222222221
122222222221111030111222222221
122222222210000010000122222221
122222222210000001000122222221
122222222210000001000122222221
122222222211000011001122222221
122222222211112111211222222221
122222222122222222222122222221
122222222211112111211222222221
122222222210000000001222222221
122222222210000000001222222221
122222222210000000001222222221
122222222210000000001222222221
122222222210000000001222222221
122222222210000000001222222221
122222222210000000001222222221
122222222210000000001222222221
122222222210000000001222222221
122222222210000000001222222221
122222222210000000001222222221
122222222210000000001222222221
122222222210000000001222222221
122222222210000000001222222221
122222222210000000001222222221
122222222210000000001222222221
122222222210000000001222222221
122222222210000000001222222221
122222222210000000001222222221
122211112210000000001221111221
122103001210000000001210300121
121000000110000000001100000121
121000000100000000001000000121
121000000000000000000000000121
121000000000000000000000000121
122100000000000000000000001221
122211110000000000000011112221
111111111111111111111111111111
