111111111111111111111111111111
100000000000000000000000000001
100000000001111030111000000001
100000000012222212222100000001
100000000012222212222100000001
100000000012222212222100000001
100000000011222222221100000001
100000000011121111211000000001
100000000100000000000100000001
100000000011121111211000000001
100000000012222222221000000001
100000000012222222221000000001
100000000012222222221000000001
100000000012222222221000000001
100000000012222222221000000001
100000000012222222221000000001
100000000012222222221000000001
100000000012222222221000000001
100000000012222222221000000001
100000000012222222221000000001
100000000012222222221000000001
100000000012222222221000000001
100000000012222222221000000001
100000000012222222221000000001
100000000012222222221000000001
100000000012222222221000000001
100000000012222222221000000001
100000000012222222221000000001
100003000012222222221000030001
100011110012222222221001111001
100122221012222222221012222101
101222222112222222221122222101
101222222122222222221222222101
101222222222222222222222222101
101222222222222222222222222101
100122222222222222222222221001
100011112222222222222211110001
111111111111111111111111111111
