1111111111
1200300021
1200000021
1222222221
1000000001
1000300001
1000000001
1222222221
1000000001
1000300001
1000000001
1222222221
1000000001
1000300001
1000000001
1222222221
1000300001
1000000001
1222222221
1000300001
1000000001
1222222221
1000300001
1000000001
1222222221
1000300001
1000000001
1000000001
1000000001
1000000001
1000000001
1222222221
1000000001
1000300001
1000000001
1222222221
1000110001
1000110001
1000110001
1030110301
1000110001
1222222221
1000000001
1000000001
1000300001
1000000001
1222222221
1000110001
1030110301
1000110001
1222112221
1000110001
1030110301
1111111111
