111111111111111111111111111111111111111111111111111111111111111111111111111111111111
122222222222222222222222222222222222222222222222222222222222222222222222222222222221
130000000000000000000000000000000000000000000000000000000000000000000000000000000031
122222222222222222222222222222222222222222222222222222222222222222222222222222222221
111111111111111111111111111111111111111111111111111111111111111111111111111111111111
