11111111111111
11220000220031
12220000220001
10000100000001
13000001112101
10020100022001
12220000222001
10000000200031
11111111111111